1111111111111111111111
1C010000C00C0001CCC011
10D0011100000C01111001
100011CC00D0CC00001C01
10P011000000110C0110D1
1001CC00000C110DDC10D1
100DC11111001100001001
1001100CC0001DD00000C1
100011E00000C000011W01
1111111111111111111111