1111111111111111111111
100DC11W00D01100001001
1000000CC0001DD00C00C1
10P011E00000C000011C01
1111111111111111111111